あ	ア	ｱ	ぁ	ァ	ｧ
い	イ	ｲ	ぃ	ィ	ｨ	ゐ	ヰ
う	ウ	ｳ	ぅ	ゥ	ｩ
え	エ	ｴ	ぇ	ェ	ｪ	ゑ	ヱ
お	オ	ｵ	ぉ	ォ	ｫ
か	カ	ｶ
き	キ	ｷ
く	ク	ｸ
け	ケ	ｹ
こ	コ	ｺ
さ	サ	ｻ
し	シ	ｼ
す	ス	ｽ
せ	セ	ｾ
そ	ソ	ｿ
た	タ	ﾀ
ち	チ	ﾁ
つ	ツ	ﾂ	っ	ッ	ｯ
て	テ	ﾃ
と	ト	ﾄ
な	ナ	ﾅ
に	ニ	ﾆ
ぬ	ヌ	ﾇ
ね	ネ	ﾈ
の	ノ	ﾉ
は	ハ	ﾊ
ひ	ヒ	ﾋ
ふ	フ	ﾌ
へ	ヘ	ﾍ
ほ	ホ	ﾎ
ま	マ	ﾏ
み	ミ	ﾐ
む	ム	ﾑ
め	メ	ﾒ
も	モ	ﾓ
や	ヤ	ﾔ	ゃ	ャ	ｬ
ゆ	ユ	ﾕ	ゅ	ュ	ｭ
よ	ヨ	ﾖ	ょ	ョ	ｮ
ら	ラ	ﾗ
り	リ	ﾘ
る	ル	ﾙ
れ	レ	ﾚ
ろ	ロ	ﾛ
わ	ワ	ﾜ
を	ヲ	ｦ
ん	ン	ﾝ

が	ガ	ｶﾞ
ぎ	ギ	ｷﾞ
ぐ	グ	ｸﾞ
げ	ゲ	ｹﾞ
ご	ゴ	ｺﾞ
ざ	ザ	ｻﾞ
じ	ジ	ｼﾞ
ず	ズ	ｽﾞ
ぜ	ゼ	ｾﾞ
ぞ	ゾ	ｿﾞ
だ	ダ	ﾀﾞ
ぢ	ヂ	ﾁﾞ
づ	ヅ	ﾂﾞ
で	デ	ﾃﾞ
ど	ド	ﾄﾞ
ば	バ	ﾊﾞ
び	ビ	ﾋﾞ
ぶ	ブ	ﾌﾞ
べ	ベ	ﾍﾞ
ぼ	ボ	ﾎﾞ
ぱ	パ	ﾊﾟ
ぴ	ピ	ﾋﾟ
ぷ	プ	ﾌﾟ
ぺ	ペ	ﾍﾟ
ぽ	ポ	ﾎﾟ

<	(	[	{	（	［	｛	「	『	【	＜
>	)	]	}	）	］	｝	」	』	】	＞
”	"	’	'	`	‘
,	､	、	，
.	｡	。	．
a	ａ	A	Ａ
b	ｂ	B	Ｂ
c	ｃ	C	Ｃ
d	ｄ	D	Ｄ
e	ｅ	E	Ｅ
f	ｆ	F	Ｆ
g	ｇ	G	Ｇ
h	ｈ	H	Ｈ
i	ｉ	I	Ｉ
j	ｊ	J	Ｊ
k	ｋ	K	Ｋ
l	ｌ	L	Ｌ
m	ｍ	M	Ｍ
n	ｎ	N	Ｎ
o	ｏ	O	Ｏ
p	ｐ	P	Ｐ
q	ｑ	Q	Ｑ
r	ｒ	R	Ｒ
s	ｓ	S	Ｓ
t	ｔ	T	Ｔ
u	ｕ	U	Ｕ
v	ｖ	V	Ｖ
w	ｗ	W	Ｗ
x	ｘ	X	Ｘ
y	ｙ	Y	Ｙ
z	ｚ	Z	Ｚ

!	！
?	？
